0,0,0,0,0,0,0,0,0,0,0,0,0,0,0
0,3,3,1,0,0,0,0,1,0,4,6,0,0,0
0,3,1,2,2,0,1,0,0,0,8,10,0,0,0
1,1,3,0,0,0,0,0,0,0,12,14,0,3,0
0,0,0,0,0,2,2,0,0,0,0,0,0,0,0
0,0,0,0,2,3,1,2,0,0,0,0,0,0,0
0,0,2,2,3,2,3,0,0,0,1,0,1,0,0
0,0,0,0,0,0,0,0,0,0,0,0,0,0,0
0,0,4,5,5,5,6,3,0,0,0,0,0,0,0
0,0,8,9,9,9,10,0,0,1,0,0,0,0,1
0,0,8,9,9,9,10,0,0,0,0,1,0,0,0
0,0,8,9,9,9,10,0,0,0,0,0,4,6,0
0,0,12,13,13,13,14,0,1,1,1,0,8,10,0
0,0,0,0,0,0,0,0,0,1,1,0,12,14,0
0,0,0,0,0,0,0,0,0,0,0,0,0,0,0
